"filename", "language", "Python", "pip requirements", "Markdown", "HTML", "CSS", "comment", "blank", "total"
"c:\Users\User\Documents\Softwhere\python\django\vidio\MyAccount\__init__.py", "Python", 0, 0, 0, 0, 0, 0, 1, 1
"c:\Users\User\Documents\Softwhere\python\django\vidio\MyAccount\admin.py", "Python", 5, 0, 0, 0, 0, 1, 0, 6
"c:\Users\User\Documents\Softwhere\python\django\vidio\MyAccount\apps.py", "Python", 4, 0, 0, 0, 0, 0, 3, 7
"c:\Users\User\Documents\Softwhere\python\django\vidio\MyAccount\forms.py", "Python", 11, 0, 0, 0, 0, 0, 3, 14
"c:\Users\User\Documents\Softwhere\python\django\vidio\MyAccount\migrations\0001_initial.py", "Python", 47, 0, 0, 0, 0, 1, 7, 55
"c:\Users\User\Documents\Softwhere\python\django\vidio\MyAccount\migrations\0002_remove_customuser_vidio_customuser_active_and_more.py", "Python", 27, 0, 0, 0, 0, 1, 6, 34
"c:\Users\User\Documents\Softwhere\python\django\vidio\MyAccount\migrations\0003_customuser_date_of_birth_customuser_gender_and_more.py", "Python", 22, 0, 0, 0, 0, 1, 6, 29
"c:\Users\User\Documents\Softwhere\python\django\vidio\MyAccount\migrations\0004_remove_customuser_interests_customuser_interests.py", "Python", 17, 0, 0, 0, 0, 1, 6, 24
"c:\Users\User\Documents\Softwhere\python\django\vidio\MyAccount\migrations\0005_alter_customuser_gender_alter_customuser_interests.py", "Python", 18, 0, 0, 0, 0, 1, 6, 25
"c:\Users\User\Documents\Softwhere\python\django\vidio\MyAccount\migrations\0006_alter_customuser_backgtound_alter_customuser_icon.py", "Python", 17, 0, 0, 0, 0, 1, 6, 24
"c:\Users\User\Documents\Softwhere\python\django\vidio\MyAccount\migrations\__init__.py", "Python", 0, 0, 0, 0, 0, 0, 1, 1
"c:\Users\User\Documents\Softwhere\python\django\vidio\MyAccount\models.py", "Python", 39, 0, 0, 0, 0, 1, 14, 54
"c:\Users\User\Documents\Softwhere\python\django\vidio\MyAccount\tests.py", "Python", 1, 0, 0, 0, 0, 1, 2, 4
"c:\Users\User\Documents\Softwhere\python\django\vidio\MyAccount\urls.py", "Python", 10, 0, 0, 0, 0, 0, 2, 12
"c:\Users\User\Documents\Softwhere\python\django\vidio\MyAccount\views.py", "Python", 50, 0, 0, 0, 0, 1, 14, 65
"c:\Users\User\Documents\Softwhere\python\django\vidio\README.md", "Markdown", 0, 0, 21, 0, 0, 0, 12, 33
"c:\Users\User\Documents\Softwhere\python\django\vidio\help\__init__.py", "Python", 0, 0, 0, 0, 0, 0, 1, 1
"c:\Users\User\Documents\Softwhere\python\django\vidio\help\admin.py", "Python", 1, 0, 0, 0, 0, 1, 2, 4
"c:\Users\User\Documents\Softwhere\python\django\vidio\help\apps.py", "Python", 4, 0, 0, 0, 0, 0, 3, 7
"c:\Users\User\Documents\Softwhere\python\django\vidio\help\migrations\__init__.py", "Python", 0, 0, 0, 0, 0, 0, 1, 1
"c:\Users\User\Documents\Softwhere\python\django\vidio\help\models.py", "Python", 1, 0, 0, 0, 0, 1, 2, 4
"c:\Users\User\Documents\Softwhere\python\django\vidio\help\tests.py", "Python", 1, 0, 0, 0, 0, 1, 2, 4
"c:\Users\User\Documents\Softwhere\python\django\vidio\help\urls.py", "Python", 7, 0, 0, 0, 0, 0, 2, 9
"c:\Users\User\Documents\Softwhere\python\django\vidio\help\views.py", "Python", 13, 0, 0, 0, 0, 1, 3, 17
"c:\Users\User\Documents\Softwhere\python\django\vidio\main\__init__.py", "Python", 0, 0, 0, 0, 0, 0, 1, 1
"c:\Users\User\Documents\Softwhere\python\django\vidio\main\admin.py", "Python", 13, 0, 0, 0, 0, 1, 5, 19
"c:\Users\User\Documents\Softwhere\python\django\vidio\main\apps.py", "Python", 4, 0, 0, 0, 0, 0, 3, 7
"c:\Users\User\Documents\Softwhere\python\django\vidio\main\forms.py", "Python", 8, 0, 0, 0, 0, 0, 3, 11
"c:\Users\User\Documents\Softwhere\python\django\vidio\main\migrations\0001_initial.py", "Python", 19, 0, 0, 0, 0, 1, 7, 27
"c:\Users\User\Documents\Softwhere\python\django\vidio\main\migrations\0002_vidio_publick_vidio_relateed_to_chenel_vidio_watched.py", "Python", 26, 0, 0, 0, 0, 1, 6, 33
"c:\Users\User\Documents\Softwhere\python\django\vidio\main\migrations\0003_color.py", "Python", 15, 0, 0, 0, 0, 1, 6, 22
"c:\Users\User\Documents\Softwhere\python\django\vidio\main\migrations\0004_remove_color_color_color_extra_color_and_more.py", "Python", 47, 0, 0, 0, 0, 1, 6, 54
"c:\Users\User\Documents\Softwhere\python\django\vidio\main\migrations\0005_chapter_color_chapter_color_color_chapter_color2_and_more.py", "Python", 33, 0, 0, 0, 0, 1, 6, 40
"c:\Users\User\Documents\Softwhere\python\django\vidio\main\migrations\0006_rename_slag_chapter_slug.py", "Python", 12, 0, 0, 0, 0, 1, 6, 19
"c:\Users\User\Documents\Softwhere\python\django\vidio\main\migrations\0007_remove_vidio_topik_vidio_topik.py", "Python", 16, 0, 0, 0, 0, 1, 6, 23
"c:\Users\User\Documents\Softwhere\python\django\vidio\main\migrations\0008_delete_color.py", "Python", 10, 0, 0, 0, 0, 1, 6, 17
"c:\Users\User\Documents\Softwhere\python\django\vidio\main\migrations\0009_alter_vidio_topik.py", "Python", 12, 0, 0, 0, 0, 1, 6, 19
"c:\Users\User\Documents\Softwhere\python\django\vidio\main\migrations\0010_vidio_content_is_18_plus.py", "Python", 12, 0, 0, 0, 0, 1, 6, 19
"c:\Users\User\Documents\Softwhere\python\django\vidio\main\migrations\0011_rename_content_is_18_plus_vidio_content_is_only_18_plus.py", "Python", 12, 0, 0, 0, 0, 1, 6, 19
"c:\Users\User\Documents\Softwhere\python\django\vidio\main\migrations\0012_alter_vidio_vidio.py", "Python", 13, 0, 0, 0, 0, 1, 6, 20
"c:\Users\User\Documents\Softwhere\python\django\vidio\main\migrations\0013_vidio_for_gender.py", "Python", 12, 0, 0, 0, 0, 1, 6, 19
"c:\Users\User\Documents\Softwhere\python\django\vidio\main\migrations\0014_remove_vidio_for_gender.py", "Python", 11, 0, 0, 0, 0, 1, 6, 18
"c:\Users\User\Documents\Softwhere\python\django\vidio\main\migrations\0015_vidio_vidio_for_gender.py", "Python", 12, 0, 0, 0, 0, 1, 6, 19
"c:\Users\User\Documents\Softwhere\python\django\vidio\main\migrations\0016_alter_vidio_vidio_for_gender.py", "Python", 12, 0, 0, 0, 0, 1, 6, 19
"c:\Users\User\Documents\Softwhere\python\django\vidio\main\migrations\__init__.py", "Python", 0, 0, 0, 0, 0, 0, 1, 1
"c:\Users\User\Documents\Softwhere\python\django\vidio\main\models.py", "Python", 44, 0, 0, 0, 0, 1, 14, 59
"c:\Users\User\Documents\Softwhere\python\django\vidio\main\templates\account\Mychenel_page.html", "HTML", 0, 0, 0, 18, 0, 0, 5, 23
"c:\Users\User\Documents\Softwhere\python\django\vidio\main\templates\account\account.html", "HTML", 0, 0, 0, 28, 0, 0, 5, 33
"c:\Users\User\Documents\Softwhere\python\django\vidio\main\templates\account\login.html", "HTML", 0, 0, 0, 116, 0, 0, 16, 132
"c:\Users\User\Documents\Softwhere\python\django\vidio\main\templates\account\signup.html", "HTML", 0, 0, 0, 172, 0, 0, 15, 187
"c:\Users\User\Documents\Softwhere\python\django\vidio\main\templates\extenders\header.html", "HTML", 0, 0, 0, 150, 0, 13, 26, 189
"c:\Users\User\Documents\Softwhere\python\django\vidio\main\templates\help\error.html", "HTML", 0, 0, 0, 29, 0, 0, 4, 33
"c:\Users\User\Documents\Softwhere\python\django\vidio\main\templates\help\main.html", "HTML", 0, 0, 0, 130, 0, 0, 6, 136
"c:\Users\User\Documents\Softwhere\python\django\vidio\main\templates\help\status.html", "HTML", 0, 0, 0, 18, 0, 0, 5, 23
"c:\Users\User\Documents\Softwhere\python\django\vidio\main\templates\main\new_vidio.html", "HTML", 0, 0, 0, 66, 0, 0, 4, 70
"c:\Users\User\Documents\Softwhere\python\django\vidio\main\templates\main\topik.html", "HTML", 0, 0, 0, 20, 0, 6, 3, 29
"c:\Users\User\Documents\Softwhere\python\django\vidio\main\templates\main\vidio.html", "HTML", 0, 0, 0, 20, 0, 6, 3, 29
"c:\Users\User\Documents\Softwhere\python\django\vidio\main\templates\main\watch_vidio.html", "HTML", 0, 0, 0, 41, 0, 6, 5, 52
"c:\Users\User\Documents\Softwhere\python\django\vidio\main\tests.py", "Python", 1, 0, 0, 0, 0, 1, 2, 4
"c:\Users\User\Documents\Softwhere\python\django\vidio\main\urls.py", "Python", 10, 0, 0, 0, 0, 0, 2, 12
"c:\Users\User\Documents\Softwhere\python\django\vidio\main\views.py", "Python", 177, 0, 0, 0, 0, 1, 30, 208
"c:\Users\User\Documents\Softwhere\python\django\vidio\manage.py", "Python", 15, 0, 0, 0, 0, 3, 5, 23
"c:\Users\User\Documents\Softwhere\python\django\vidio\requirements.txt", "pip requirements", 0, 17, 0, 0, 0, 0, 0, 17
"c:\Users\User\Documents\Softwhere\python\django\vidio\static\css\account\grid.css", "CSS", 0, 0, 0, 0, 0, 0, 1, 1
"c:\Users\User\Documents\Softwhere\python\django\vidio\static\css\account\main.css", "CSS", 0, 0, 0, 0, 23, 0, 3, 26
"c:\Users\User\Documents\Softwhere\python\django\vidio\static\css\extends\grid.css", "CSS", 0, 0, 0, 0, 0, 0, 1, 1
"c:\Users\User\Documents\Softwhere\python\django\vidio\static\css\extends\main.css", "CSS", 0, 0, 0, 0, 38, 0, 7, 45
"c:\Users\User\Documents\Softwhere\python\django\vidio\static\css\help\grid.css", "CSS", 0, 0, 0, 0, 0, 0, 1, 1
"c:\Users\User\Documents\Softwhere\python\django\vidio\static\css\help\main.css", "CSS", 0, 0, 0, 0, 77, 0, 13, 90
"c:\Users\User\Documents\Softwhere\python\django\vidio\static\css\mychenel\grid.css", "CSS", 0, 0, 0, 0, 5, 0, 0, 5
"c:\Users\User\Documents\Softwhere\python\django\vidio\static\css\mychenel\main.css", "CSS", 0, 0, 0, 0, 44, 0, 12, 56
"c:\Users\User\Documents\Softwhere\python\django\vidio\static\css\topik\grid.css", "CSS", 0, 0, 0, 0, 59, 1, 14, 74
"c:\Users\User\Documents\Softwhere\python\django\vidio\static\css\topik\main.css", "CSS", 0, 0, 0, 0, 75, 0, 21, 96
"c:\Users\User\Documents\Softwhere\python\django\vidio\static\css\vidio\grid.css", "CSS", 0, 0, 0, 0, 59, 1, 14, 74
"c:\Users\User\Documents\Softwhere\python\django\vidio\static\css\vidio\main.css", "CSS", 0, 0, 0, 0, 75, 0, 21, 96
"c:\Users\User\Documents\Softwhere\python\django\vidio\static\css\watch_vidio\grid.css", "CSS", 0, 0, 0, 0, 25, 0, 4, 29
"c:\Users\User\Documents\Softwhere\python\django\vidio\static\css\watch_vidio\main.css", "CSS", 0, 0, 0, 0, 100, 0, 29, 129
"c:\Users\User\Documents\Softwhere\python\django\vidio\vidio\__init__.py", "Python", 0, 0, 0, 0, 0, 0, 1, 1
"c:\Users\User\Documents\Softwhere\python\django\vidio\vidio\asgi.py", "Python", 4, 0, 0, 0, 0, 8, 5, 17
"c:\Users\User\Documents\Softwhere\python\django\vidio\vidio\settings.py", "Python", 78, 0, 0, 0, 0, 27, 28, 133
"c:\Users\User\Documents\Softwhere\python\django\vidio\vidio\urls.py", "Python", 13, 0, 0, 0, 0, 15, 3, 31
"c:\Users\User\Documents\Softwhere\python\django\vidio\vidio\wsgi.py", "Python", 4, 0, 0, 0, 0, 8, 5, 17
"Total", "-", 940, 17, 21, 808, 580, 128, 548, 3042